F 0,0,1
C 255,253,1


EA ./textures/east.xpm

NO ./textures/north.xpm

SO ./textures/south.xpm

   WE ./textures/west.xpm



 11111111111111111111111111
1000000000110000000000001
1011000001110000000000001
100100000000000000000000111111111
11111111101100000111000000000001
10000S0011000001110111111111111
1111011111111101110000010001
11110111111111011101010010001
11000000110101011100000010001
1000000000000000110000001001
1000000000000000110110010001
110000011101010111110111100111
11110111 1110101 101111010001
11111111 1111111 11111111111
